#########################################################
#########################################################
#########################################################
###@..%%%.........###.................................###
###...%%%.........###.................................###
###...###.........###.................................###
###...###...%%%...###...%%#####%%%%###%%%%###...###...###
###...###...%%%...###...%%#####%%%%###%%%%###...###...###
###...###...%%%...%%%...%%#####%%%%###%%%%###...###...###
###...###...%%#...%%%...............##%.........###...###
###...###...%%#...%%%...............%%#.........###...###
###...###...%%#...%%%...............%%#.........###...###
###...%%%...###...###%%%%%%%%####...%%#...#%%%%##########
###...%%%...###...###%%%%%%%%####...%%#...#%%%%##########
###...%%%...###...###%%%%%%%%####...###...#%%%%##########
###.........###...###...............%%#...#%%.........###
###.........%%%...###...............%%#...%%%.........###
###.........%%%...%%%...............%%#...%%%.........###
###########%%%%...%%%############...%%#...%%%...###...###
###########%%%%...%%%########%%%%...###...%%%...###...###
############%%%...%%%########%%%%...###...###...###...###
###.........%%%...............%%%...###.........###...###
###.........###...............%%%...###.........###...###
###.........%##...............##%...%%%.........###...###
###...###%%%%#####%%%%#####...##%%%%%%%...%%%%#####...###
###...###%%%%#####%%%%#####...##%%%%%%%...%%%%#####...###
###...###%%%%##############...######%%%...%%%%#%%%%...###
###.....................###.........###.........%%%...###
###.....................###.........###.........%%%...###
###.....................###.........#%%.........%%%...###
###...%%%%###########...######%%%...#%%%%##########...###
###...%%%%###########...######%%%...#%%%%##########...###
###...%%%%###########...######%%%...#%%%%##########...###
###...%%%.........###.........%%%.....................###
###...###.........###.........%%%.....................###
###...###.........###.........%%%.....................###
#########...%%%...###...###...%%%%#%%%%##%%%%%%####...###
#########...%%%...###...###...#####%%%%##%%%%%%####...###
#########...%%%...###...###...#####%%%%############...###
###.........%%%.........###.........###...............###
###.........%%#.........###.........%%%...............###
###.........%%#.........###.........%%%...............###
###...##%%%%%%#...%%#########%%%%...%%%...###############
###...##%%%%%%#...%%#########%%%%...%%%...###############
###...#########...%%%%#######%%%%...%%%...###############
###...###.........%%%.........%%%...%%%...............###
###...###.........%%%.........%%%...%%%...............###
###...###.........%%%.........%%%...###...............###
###...########%%%%###...###...%%%%#######%%%%######...###
###...########%%%%###...###...###########%%%%######...###
###...########%%%%###...###...###########%%%%######...###
###.....................###...........................xx#
###.....................###...........................xx#
###.....................###...........................xx#
#########################################################
#########################################################
#########################################################
