###########################################################
#@#.....#.......#.............%.........%...........#.....#
#.#.#%#.#.#####.#.%.####%##%#.#.####%##.#.##%#####%.#.#.#.#
#...#.#...#...#.#.#.#...%.....%.......#.#.#.....#.#.#.#.%.#
#####.#####.#.#.%.#.##%.#.%##########.#.#.%.%##.%.#.%.#.#.#
#...........#.#.#.#...#.#.%.......#...#.#.#...%...#...#.#.#
#.####%###%####.#.###.#.#.##%.##%.#.###.#.###.%########.%.#
#.#.........%...#.#.#.%.......#.#.%.#.%.%...#.....#.....#.#
#.#.#%#####.#.###.#.%.#####%#%#.#.#.%.#.###.%.###.#.%##%###
#.#...#...#...%.#...#.#...%.......#.%.#.#...%.#...#.......#
#.%##.#.#.#%###.#.%##.#.#.%##.####%.#.%.#.#####.#.####%%#.#
#.#...#.#...#.....#...#.#...#.......#.#.#.#.....#.#...#...#
#.#.%##.###.#.%%###.%.#.##%.####%####.#.#.%.%##%#.#.#.#.%##
#.#.#...#...#.....#.#.#...%.......#...#.#...#.#...#.#.#...#
#.#.###.#.#%%######.####%.###%###.%.##%.###%#.#.###.#.###.#
#.#.....#.....#...#.....#.#...#...#.....%...%.....%.#...#.#
#.#%###%##%#%.#.#.#.#.###.##%.#.#######.%##.#.%%###.###.%.#
#...%...#...%.#.#.#.#.........#.......#.#...#.%.....#.....#
#%#.%.#.%.#.#.%.#.%######%##%####%###.#.#.#%%.%.#######%#.#
#...#.%...#.#...#.#.........#.........#...#...#.#.....#...#
#.###.####%.%###%.#.###%##%.#.##%######.%#%.###.%.##%.#%###
#.....%...%...#.#...#...#...#...#.....#.#...%.#...#.%.....#
#.%####.#.#.#.%.#####.#.#.%###%.#.#.###.#.%##.###%#.%##%#.#
#.%.....#.#.#...#.....#.#.....#.%.#.%...#.#.........#...#.#
#.###.%#%.%.#####.##%##.%##%#.#.#.%.#.###.#.#%%.#.###.#.#.#
#...%.#...#...#...#.........#.#.#.#.%...#.%.#...#.#...%...#
###.#.#.#.%##.#.#%%.%#%#%####.#.#.###.###.##%.#####.#####.#
#...#.#.%...#...%.#.....#.....#.#.....#...#...#.....#...#.#
#.##%##.%##.####%.%###%.#.#%###.%.###%#.###.#.#.%####.###.#
#.......#...#.........#...#.....#.#.....#...#.%.%.........#
#######%#.%##.#%%%#.%.%####.#%###.#.####%%#.%.#.###%##%#%##
#.....%...#...#.....#.......#.#...#.#.......#.#...#.......#
##%.%.#.###.###.#####%#%#%###.#.%%#.#.###.%%#.###.%.%%#%#.#
#...#.#...#...#...#.....#.....%.%...#...#...%.#.#.#.#...#.#
#.##%.%#%.#######.#.###.#.%####.#.###%%.#%#.#.#.#.#.%.###.#
#.#...%...%.....#...#...#.......#...#.....#.#...#.....#...#
#.#####.###.###.#####.#.%###%##%%%%.#.###%#.####%#%.%##.#.#
#.....#.%...#.......#.#.#.........#.#.#...#.#.....#.#...#.#
#####.#.#%#.#######.%.#.#.#####.###.###.%.#.#.###.%##.##%.#
#.....#...%.#...#.....#.#.#...#.....#...%...#.#.....%...#.#
#.#######.%.%.#.#%#.###%#.#.#.%%#%%%#.#######.%####.##%.#.#
#.#.....%.#.#.%...#.#.....#.#.........%...#...#...#.....#.#
#.#.#.###.#.%.###.%.#.########%##.%.#%#.#.#.%##.#.##%######
#...#...#.#.....#.%.#...%.....#...#.#...#.%.....#.........#
#####%#.#.%#%####.#####.#%#.#.#.###.#.###.###########%#.#.#
#.......#...#...#.....%.....#.#.#...#...#.........%...#.#.#
#.##%%#.##%.#.#.#.###.#.###%#.#.#####%%.#########.#.#.##%.#
#.%.......#...#.%...#...#...#...%.....#.#.......#...#.#...#
#.%.####%%#####.#.##%####.#.#.%%%.###.#.#####%#.##%##.#.%.#
#.#.#.........#.#.%.......#.#.#...#.%.#.#...........%...#.#
#.%#%.%######.#.#.#.#%#####.###.###.%.%.#.%.%#%#%%###%###.#
#.#...#.#.....#.#.#.#.....%.%...#...#.%.#.#.#...#.......#.#
#.#.#%#.#.###.#.###.%%#%#.#.#.###.#.%.#.#.#.#.#.#.#####.#.#
#.#...#.#.%...#.....#.....#...#...#...#.#.%.#.#...#...#...#
#.###.#.#.%######%%#%.#####%###.%####%#.#.#.%.#%#%#.#.#####
#.....#.#.#...#.......#.......#...#...#.%.#.#.%.....#.....#
#.%%%##.%.#.#.#.#####.#.%.#######.%.#.#.%.##%.#%%####.###.#
#.......#...#.......#...#...........#...#.............#...x
###########################################################
