#x###############################
#.%.......#...................#.#
#.%.#####.###########.###%#%#.#.#
#...#.....#.....#...#.#.#.....#.#
##%#%.#%###.###.#.#.#.#.#.####%.#
#...#.#.......#...#...#...#...%.#
#.#.%.%%%.###.##%%#####.#%#.#.#.#
#.#.%...#.#.#.....#...%.#...%.#.#
#.#####.#.#.###%%.%.#.#.###.#.#.#
#.%...%.#.#.....#...#.#.....#.#.#
#.#.#.#.#.#.#.#%#####.#######.#.#
#...#...#...#.%...%...#.....#.#.#
#.%####%######%.%.#.#%#.#.%.#.#.#
#...#.....%.....#...#...#.#.#.%.#
###.###.#.#.#%#%#####.###.#%%.#.#
#.#.....#.#.#...#.....#.%.....#.#
#.%######.#.###.#.##%##.%####%#.#
#.......#.%.#...%.....#.....#...#
#.###.#.#.#.#.#####%#.#.#####.#.#
#.%...#.#...#.#.....#.#.......#.#
#.#.%#%.%%###.%.###.#.#.%##%##%.#
#.#.%.........#.%.#.#.%...#.....#
##%.#.%########.#.#.#.%####.###.#
#...#.#.........%.#...#...%.#.#.#
#.#####.###%#%###.%#%##.#.#.#.#.#
#.#.....#.......%.......%...#.#.#
#.#.####%#%.###.%.#####%#####.#.#
#.#.#.....#...#.#...#.....#.....#
#.#.###.%.###.#.###.#.###.#.#####
#.#.....#.%...#.%...#...#...#...#
#.%%####%.#.###.#.#####.#####.#.#
#...........#.....#...........#.x
#################################
