#########################################################
#########################################################
#########################################################
########@.......%%%%####%%%%####%%%%########%%%%###%%%###
########........%%%%####%%%%####%%%%######%%%%%%%%#%%%###
########........########%%%%#%%%%#########%%%%%%%%%%%%###
########........########%%%%#%%%%#%%%%####%%%%%%%%%%%%###
########........#############%%%%#%%%%####%%%%%%%%%%%####
########........................%#%%%%##........#%%%%####
#####%%%........................##%%%%##........#########
#####%%%........................########........#########
#####%%%........................########........#########
#####%%%........................########........#########
########........................########........#########
########........................####%%%%........###%%%###
########........................####%%%%........###%%%###
########%%%%####%%%%#%%%........%%%%%%%%........###%%%###
########%%%%####%%%%#%%%........%%%%%%%%........###%%%###
###%%####%%%%########%%%........%%%%####........##%%%%###
###%%####%%%%########%%%........%%%%####........##%%%%###
###%%%%##%%%%#######%%%%........%%%#####........%%%%%%###
###%%%%%%%%%%#%%%%##%%%%........%%%#%%%%........%%%%%%###
###%%%%%%%%%%#%%%%##%%%%........%%%#%%%%........%%%######
###%%%%%%%%%%#%%%%##%%%%........%%%#%%%%........%%%######
###%%%%%........%%######........................#########
###%%###........########........................#########
###%%###........%%%#####........................#########
###%%###........%%%#####........................#########
########........%%%#####........................#########
#####%%%........%%%#####........................#########
#####%%%........%%%#####........................#########
#####%%%........%%%#####........................#########
###%%%%%........%%%#%%%%##%%%%####%%%%%%........#########
###%%%##........####%%%%##%%%%####%%%%%%........#########
###%%%##........####%%%%##%%%%%#####%%%%........%%#######
###%%%%%........####%%%%###%%%%#####%%%%........%%#######
###%%%%%........%%%%#######%%%%#########........%%#######
###%%%%%........%%%%#######%%%%#########........%%#######
####%%%%........%%%%####################........#########
########........%%%%####################........#########
########........................................xxxxxxxx#
########........................................xxxxxxxx#
########........................................xxxxxxxx#
########........................................xxxxxxxx#
########........................................xxxxxxxx#
########........................................xxxxxxxx#
########........................................xxxxxxxx#
########........................................xxxxxxxx#
#########%%%%############%%%%####%%%%#########%%%########
#########%%%%############%%%%#######%%%%#################
###%%%%%%###################%%%%%%%#%%%%#%%%%############
###%%%%%%###################%%%%%%%#%%%%#%%%%############
###%%%%%%###################%%%%%%%#%%%%#%%%%############
###%%%%%%###################%%%%%%%######%%%%############
#########################################################
#########################################################
#########################################################
